NO path
EA path
WE path
SO path

C 252,253,123
F 252,253,255
C 252,253,123

1111111111
1000000001
100N000001
1000000001
1111111111