NO sprites/WALL1.xpm
EA sprites/WALL2.xpm
WE sprites/WALL3.xpm
SO sprites/WALL4.xpm
F 150,150,150
C 70,70,70
111111111111111111111111111111111111
100000000000000000000000000000000001
100010000000000000000000000000000001
100010001000000000000000000000000001
100000000000000000000000000000000001
100000000000000000000000000000000001
100000000000000000000000000000000001
10000N000000000000000000011000000001
100000000000000000000000011100000001
100000000000000010000000000000000001
100000000000000010000000000000000001
100000000000001100000000000000000001
100000000001110000000010000000000001
100011000000000000001100000000000001
100001000000000000000000000000000001
100001000000000001000000000000000001
100000000000000000000000000010000001
100000000000000110000000000000100001
100000000000000000000000000000000001
111111111111111111111111111111111111