1111111111
1000000001
1111000001
1000000001
1000001001
1000001001
100000100111111111
100000000000000001
100000000000000001
100000000000000001
100000000000000001
100000000000000001
100000000000000001
111111100000000001
      100111111001
      1001    1001
      1001    1111
      100111111001
      1000010000N1
      111111111111