NO sprites/Bricks.xpm
EA sprites/Castle-Wall.xpm
WE sprites/Bricks.xpm
SO sprites/Castle-Wall.xpm

F 150,150,150
C 40,40,40

1111111111
1000000001
1000000001
1000000001
1000000001
1000W00001
1000000001
1001110001
1000000001
1111111111
