NO path
SO path
EA path
WE path

F 255,255,255
C 1,2,3,4

1111111111111
1000000000001
1111111111111
