NO path
EAS path      
WE path
SO path

F 252,253,255

C 1,2,2

1111111111
1000000001
1111000001
1000000001
100N001001
1000001001
100000100111111111
111111100000000001
      100111111001
      1001    1001
      1001    1111
      100111111001
      100001000001
      111111111111
