NO path 3
EA path
WE path
SO path

F 252,253,255 3

C 1,2,3

1111111011111
1000000000001
1111111111111
