NO path
SO path
EA path
WE path

F 252,253,254
C 1,2,3

1111111011111
1000000000001
1111111111111