NO path
EA path      
WE path
SO path

F 252,253,255

C 1,2,2

111111
1N0001
101001
100101
100001
111111