NO sprites/Bricks.xpm
EA sprites/Castle-Wall.xpm
WE sprites/Bricks.xpm
SO sprites/Castle-Wall.xpm

F 0,120,120
C 110,110,200

          1111111111
          1000000001
          1111000001111111
          1000000000000001
          1000000001111111
          1000000001
    111111000000001
          1000000001111111111
          1001010000000000001
          1000N00001111111111
          1011111111
          101
          101
          101
          101
          101
          101
          101
          101
          101
          101
          101
          101
          101
          101
          101
          101
          101
          101
          101
          101
          101
          101
          101
          101
          101
          101
          101
          101
          101
          101
          101
          101
          101
          101
          101
          101
          101
          101
          101
          101
          101
          101
          101
          101
          101
          101
          101
          101
          111
