NO path
EA path      
WE path
SO path

F 252,253,255

C 1,2,2

111111111111111111
111111100000000001
      100111111001
      1001    1001
      1001    1011
      100111111001
      1000010000N1
      111111111111
