NO sprites/Bricks.xpm
EA sprites/Castle-Wall.xpm
WE sprites/Bricks.xpm
SO sprites/Castle-Wall.xpm

F 0,120,120
C 110,0,100

1111111111
1000000001
1111000001
1000000001
1000000001
1000000001
1000W00001
1000000001
1001110001
1000000001
1111111111
