NO path
EA path      
WE path
SO path

F 252,253,255

C 1,2,2

111111
100001
101001
10N101
100001
111111