       NO          textures/purp_wall.xpm
     SO    textures/pink_wall.xpm
     WE          textures/blue_wall.xpm
              EA textures/green_wall.xpm

 F       74,171,0




C 37,150,190

        1111111111111111111111111
        1000000000110000000000001
        1011000001110010000000001
        10010000000001 1000000001
111111111011000001110010000000001
100000000011000001110111110111111
11110111111111011100000010001
11110111111111011101010010001
1100000011010101110000001S001
10000000000000001100000010001
10000000000000001101010010001
110000011101010111110111100111
11110111 1110101 101111010001
11111111 1111111 111111111111



